#######
##    #
##  # #
##B # #
   ## #
 # #  #
   ## #
## #  #
     ##
A######
